1 1 1 1 1 1 1 1 1 1 1 1 1 1 1 1 1 1 1 1 1 1 1 1 1 1 1 1 1 1
1 1 0 0 0 1 1 0 0 0 0 0 0 1 1 0 0 1 1 1 0 0 0 0 0 1 1 1 1 1
1 0 0 0 4 121 1 1 0 0 0 4 100 0 0 1 1 0 0 1 1 1 0 0 3 0 0 0 0 0 0 1
1 0 1 1 0 1 1 0 0 0 0 0 0 1 1 0 0 1 1 1 4 100 0 0 0 0 1 1 4 70 0 1
1 0 1 1 0 0 4 80 0 0 1 1 4 100 0 0 0 0 0 1 1 1 0 0 0 4 40 0 1 1 1 0 1
1 0 0 0 0 0 0 0 0 1 1 0 0 0 4 80 0 0 1 1 1 0 0 0 0 4 61 1 1 4 70 0 1
1 0 0 0 1 1 1 1 1 1 1 0 1 1 1 0 0 1 1 4 100 0 0 0 0 0 1 1 1 0 1
1 0 0 0 1 1 1 1 1 1 1 0 1 1 1 4 120 0 0 1 0 0 0 0 0 0 1 1 4 70 0 1
1 4 100 0 0 0 0 0 0 0 0 0 0 1 1 1 1 1 0 0 0 1 1 1 1 1 1 1 1 0 1
1 0 0 0 0 0 4 301 0 0 0 1 1 1 1 1 1 1 1 1 1 1 1 1 1 1 1 1 1 0 1
1 0 0 0 0 0 0 0 0 0 4 41 0 0 0 0 0 0 1 1 1 1 1 1 1 1 1 1 4 70 0 1
1 1 1 1 1 0 0 0 0 0 0 0 0 0 0 0 0 0 0 0 0 0 0 0 0 0 0 0 0 1
1 1 1 1 1 0 0 0 0 0 0 0 0 1 1 0 0 0 0 0 0 0 0 0 0 0 0 0 0 1
1 1 1 1 1 0 0 0 4 100 0 0 0 0 1 1 0 0 0 0 0 0 0 0 0 0 0 0 0 0 1
1 1 1 1 0 0 0 0 0 0 1 1 1 1 1 1 1 1 0 4 100 0 0 0 0 0 0 0 0 0 1
1 1 0 0 0 0 0 0 0 0 1 1 1 1 1 1 1 1 1 1 1 1 1 1 1 1 1 1 0 1
1 0 0 0 0 0 0 0 0 0 1 0 0 0 1 1 1 0 0 0 0 1 1 1 1 1 1 1 0 1
1 0 0 0 0 0 0 4 100 0 0 1 0 0 0 1 1 1 0 0 0 0 1 1 1 1 1 1 1 1 1
1 4 200 0 0 0 0 0 0 0 0 1 0 0 0 1 1 1 0 0 0 0 1 1 1 1 1 1 1 0 1
1 0 0 0 0 0 0 0 0 0 0 0 0 0 0 0 0 0 0 0 0 0 4 101 0 0 0 0 0 0 1
1 0 0 0 0 0 0 0 0 0 0 0 0 0 0 0 0 0 0 0 0 0 0 0 0 0 0 0 0 1
1 0 0 0 0 0 0 0 0 0 0 0 0 0 0 0 0 0 0 0 0 0 0 0 0 0 0 0 0 1
1 0 0 0 0 0 0 0 0 0 0 0 0 0 0 0 0 0 0 0 0 0 0 0 0 0 0 0 0 1
1 0 0 0 0 0 0 0 0 0 0 0 4 105 0 0 0 0 0 0 0 4 300 0 0 0 0 0 0 0 0 1
1 0 0 0 0 0 0 0 0 0 0 0 0 0 0 0 0 0 0 0 0 0 0 0 0 0 0 0 0 1
1 0 0 0 2 0 0 0 0 4 100 0 0 0 0 0 0 0 0 0 4 201 0 0 0 0 0 0 0 0 0 1
1 0 0 0 0 0 0 0 0 0 0 0 0 0 0 0 0 0 0 0 0 0 0 0 0 0 0 0 0 1
1 0 0 0 0 0 0 0 0 0 0 0 4 106 0 0 0 0 0 0 0 0 0 0 0 0 0 0 0 0 1
1 0 0 0 0 0 0 0 0 0 0 0 0 0 0 0 0 0 0 0 0 0 0 0 0 0 0 0 0 1
1 1 1 1 1 1 1 1 1 1 1 1 1 1 1 1 1 1 1 1 1 1 1 1 1 1 1 1 1 1