1 1 1 1 1 1 1 1 1 1 1 1 1 1 1 1 1 1 1 1 1 1 1 1 1 1 1 1 1 1
1 1 0 0 0 1 1 0 0 0 0 0 0 1 1 5 3 40 0 1 1 1 4 165 4 165 0 0 6 20 450 1 1 1 1 1
1 0 0 0 0 1 1 5 2 40 0 5 2 40 0 0 0 1 1 0 0 1 1 1 0 0 0 0 0 0 0 0 0 1
1 0 1 1 0 1 1 0 0 0 0 0 1 1 1 5 3 40 0 1 1 1 0 0 0 0 0 1 1 0 0 1
1 0 1 1 0 0 0 0 0 1 1 0 1 0 0 0 0 0 0 0 0 0 0 0 0 1 1 1 0 1
1 5 3 80 0 0 0 0 0 0 0 1 1 6 850 20 0 0 0 0 0 0 0 0 0 0 0 0 0 0 0 0 0 1
1 0 0 0 1 1 1 1 1 1 1 1 1 1 1 5 3 50 0 0 0 0 5 3 40 0 0 0 0 0 0 5 3 40 0 1
1 0 0 0 1 1 1 1 1 1 1 1 1 1 1 0 0 0 0 0 0 0 0 0 0 1 2 0 0 1
1 1 4 400 0 0 0 0 0 0 0 0 1 1 1 6 280 20 0 0 0 0 0 1 1 1 1 1 1 1 1 1 1
1 6 590 20 0 0 0 0 0 0 0 0 1 1 1 1 6 200 20 0 0 0 1 1 1 1 1 1 1 1 1 1 1 1
1 0 0 0 0 0 0 0 0 0 0 0 0 0 0 0 0 1 1 1 1 1 1 1 1 1 1 0 0 1
1 0 0 0 0 0 0 0 0 0 0 0 0 0 1 0 0 0 0 0 5 3 80 0 0 5 3 80 0 0 0 0 0 1
1 6 700 20 0 0 0 0 0 0 0 0 0 0 0 0 1 1 1 0 0 0 0 0 0 0 0 0 0 0 0 1
1 0 0 0 0 0 0 0 0 0 0 0 0 0 1 1 1 0 0 0 0 0 0 0 0 0 0 0 0 1
1 6 700 20 0 0 0 0 0 0 0 0 0 0 0 0 1 1 1 1 1 1 1 0 0 0 0 0 0 0 0 1
1 1 4 530 0 0 0 0 0 0 0 0 0 0 0 1 1 1 4 530 0 0 0 0 0 0 0 0 0 0 0 1
1 5 3 120 0 0 0 5 3 110 0 0 0 1 1 4 110 0 0 1 1 1 4 160 0 0 0 1 1 1 1 1 1 1 0 1
1 0 0 0 0 0 0 0 0 1 1 4 110 0 0 1 1 1 4 160 0 0 0 1 1 1 1 1 1 1 1 1
1 0 0 0 0 0 0 0 0 1 1 4 110 0 0 1 1 1 4 160 0 0 0 1 1 1 1 1 1 1 0 1
1 0 0 0 0 0 0 0 0 0 0 0 0 0 1 1 1 0 0 0 0 0 0 0 0 0 0 0 0 1
1 6 1300 20 0 0 0 0 0 0 0 0 0 0 0 0 0 0 0 0 0 0 0 0 0 0 0 0 0 0 0 1
1 6 1300 20 0 0 0 0 0 0 0 0 0 0 0 0 0 0 0 0 0 0 0 0 0 0 0 0 0 0 0 1
1 4 1300 0 0 0 0 0 0 0 0 0 0 0 0 0 0 0 0 0 0 0 0 0 0 0 0 0 0 0 1
1 6 1300 20 0 0 0 0 0 0 0 0 0 0 0 0 0 0 0 0 0 0 0 0 0 0 0 0 0 0 0 1
1 4 1300 0 0 0 0 0 0 0 0 0 0 0 0 0 0 0 0 0 0 0 0 0 0 0 0 0 0 0 1
1 6 1300 20 0 0 0 0 0 0 0 0 0 0 0 0 0 0 0 0 0 0 0 0 0 0 0 0 0 0 0 1
1 0 3 0 0 0 0 0 0 0 0 0 0 0 0 0 0 0 0 0 0 0 0 0 0 0 0 0 0 1
1 6 1300 20 0 0 0 0 0 0 0 0 0 0 0 0 0 0 0 0 0 0 0 0 0 0 0 0 0 0 0 1
1 6 1300 20 0 0 0 0 0 0 0 0 0 0 0 0 0 0 0 0 0 0 0 0 0 0 0 0 0 0 0 1
1 1 1 1 1 1 1 1 1 1 1 1 1 1 1 1 1 1 1 1 1 1 1 1 1 1 1 1 1 1