1 1 1 1 1 1 1 1 1 1 1 1 1 1 1 1 1 1 1 1 1 1 1 1 1 1 1 1 1 1
1 1 0 0 0 1 1 0 0 0 0 0 0 1 1 0 3 1 1 1 0 0 0 0 0 1 1 1 1 1
1 0 0 0 4 101 1 1 0 0 0 4 100 0 0 1 1 0 0 1 1 1 0 0 2 0 0 0 0 0 0 1
1 0 1 1 0 1 1 0 0 0 0 0 0 1 1 0 0 1 1 1 4 100 0 0 0 0 1 1 4 70 0 1
1 0 1 1 0 0 4 100 0 0 1 1 4 100 0 0 0 0 0 1 1 1 0 0 0 4 70 0 1 1 1 0 1
1 0 0 0 0 0 0 0 0 1 1 0 0 0 4 100 0 0 1 1 1 0 0 0 0 4 71 1 1 4 70 0 1
1 0 0 0 1 1 1 1 1 1 1 0 1 1 1 0 0 1 1 4 100 0 0 0 0 0 1 1 1 0 1
1 0 0 0 1 1 1 1 1 1 1 0 1 1 1 4 60 0 1 1 0 0 0 0 0 0 1 1 4 70 0 1
1 4 100 0 0 0 0 0 0 0 0 0 0 1 1 1 1 1 1 1 0 1 1 1 1 1 1 1 1 0 1
1 0 0 0 0 0 4 100 0 0 0 1 1 1 1 1 1 1 1 1 1 1 1 1 1 1 1 1 1 0 1
1 0 0 0 0 0 0 0 0 0 4 100 0 1 1 1 1 1 1 1 1 1 1 1 1 1 1 1 4 70 0 1
1 1 1 1 1 0 0 0 0 0 0 0 0 0 1 1 1 1 1 1 1 1 1 1 1 1 0 0 0 1
1 1 1 1 1 0 0 0 0 0 0 0 0 1 1 1 1 1 1 1 1 1 1 1 1 1 4 120 0 0 1
1 1 1 1 1 0 0 0 4 100 0 0 0 1 1 1 1 1 1 1 1 1 1 1 1 1 1 4 120 0 0  1
1 1 1 1 0 0 0 0 0 0 1 1 1 1 1 1 1 1 1 1 1 1 1 1 1 1 0 0 0  1
1 1 0 0 0 0 0 0 0 0 1 1 1 1 1 1 1 1 1 1 1 1 1 1 1 1 1 1 0 1
1 0 0 0 0 0 0 0 0 0 1 0 1 1 1 1 1 1 1 0 0 1 1 1 1 1 1 1 0 1
1 0 0 0 0 0 0 4 111 0 0 1 1 1 1 1 1 1 0 0 0 0 1 1 1 1 1 1 1 0 1
1 4 111 0 0 0 0 0 0 0 0 1 1 1 1 1 1 1 0 0 0 0 1 1 1 1 1 1 1 0 1
1 0 0 0 0 0 0 0 0 0 0 0 0 0 0 0 0 0 0 0 0 0 4 111 0 0 0 0 0 0 1
1 0 0 0 0 0 0 0 0 0 0 0 0 0 0 0 0 0 0 0 0 0 0 0 0 0 0 0 0 1
1 0 0 5 3 100 0 0 0 0 0 0 5 3 100 0 0 0 0 0 0 0 0 0 0 0 0 0 0 0 0 0 0 1
1 0 0 0 0 0 0 0 0 0 0 5 3 100  0 0 0 0 0 0 0 0 0 0 0 0 0 0 0 0 0 1
1 0 0 0 0 0 5 1 150 0 0 0 0 0 0 0 0 0 0 5 3 100 0 0 0 0 0 0 0 0 0 0 0 1
1 0 0 5 2 120  0 0 0 0 0 0 0 0 0 5 2 100  0 0 0 0 0 0 0 0 0 0 0 0 0 0 0 1
1 0 0 0 0 0 0 0 0 0 0 5 2 120 0 0 0 0 0 0 0 0 0 0 0 0 0 0 0 0 0 1
1 0 0 0 5 3 1020 0 0 0 0 0 0 0 0 5 2 100 0 0 0 0 0 0 0 0 0 0 0 0 0 0 0 1
1 0 0 0 0 0 0 0 0 0 0 0 0 0 0 0 0 0 0 0 0 0 0 0 0 0 0 0 0 1
1 0 0 0 0 0 0 0 0 0 0 0 0 0 0 0 0 0 0 0 0 0 0 0 0 0 0 0 0 1
1 1 1 1 1 1 1 1 1 1 1 1 1 1 1 1 1 1 1 1 1 1 1 1 1 1 1 1 1 1